%%%%%%%%%%%%
%       624%
%      %%%%%
%%%%%      %
%135    o  %
%%%%%%%%%%%%
